###########################################
#                                         #
#                                         #
#               R                         #
#                                         #
##########################                #
#                                         #
#                                         #
#                                         #
#                                     X   #
#                                         #
###########################################