###########################################
#                                         #
#    R                                X   #
#                                         #
#                              ############
#                                         #
#                                         #
#                                         #
#                                         #
#                                     R   #
#                                         #
###########################################