###########################################
#                       R #               #
#   X                     #           R   #
#                         #               #
##################        #               #
#                         #               #
#                         #               #
#                                         #
#                                  R      #
#                                         #
#                                         #
###########################################