###########################################
#                                         #
#     R                                   #
#                                         # 
#                                         # 
#                     H                   # 
#                                         #
#                                         #
#                                         #
#                                       X #
#                                         #
###########################################