###########################################
#                                         #
#                                         #
#                    #                    #
#                    #                    #
#                    #                    #
#                    #                    #
#                    #                    #
#                    #                    #
#                    #                 X  #
#                    #                    #
###########################################