###########################################
#                         #               #
#     R         #         #  X            #
#               #         #               # 
#               #         #               # 
#################         ##########H###### 
#                         #               #
#       R                 #               #
#                         #               #
#                                         #
#                                         #
###########################################