###########################################
#                                         #
#                                         #
#                                         #
#                                         #
#                                         #
#                                         #
#                     #######       #######
#######     ######                        #
#                                         #
#                                         #
###########################################