###########################################
#                                         #
#                                 #########
#     R                           #       # 
#                                 #   X   # 
#                                 #       # 
#                                 ####R####
#                                         #
#                                         #
#                                         #
#                                         #
###########################################